11111111111111111
1P0000000010C0001
100C0100010000C01
100001C01C0010001
100000000C00000E1
11111111111111111
