111111111111111111111111111111111111111111111
100000000000000000000000000000000000000000001
1000000000000C0000000000000000000000000000E01
100000000000000000000000000000000000000000001
10P00000000C000000010000000000000000000000001
100100000000000000010000000000000000000000001
100100000000000000010000000000000000000000001
100100000000000000010000000000000000000000001
100100000000000000010000000000000000000000001
100100000000000000010000000000000000000000001
100100000000000000010000000000000000000000001
100100000000000000010000000000000000000000001
100100000000000000010000000000000000000000001
100100000000000000010000000000000000000000001
100100000000000000010000000000000000000000001
100100000000000000010000000000000000000000001
100100000000000000010000000000000000000000001
100100000000000000010000000000000000000000001
100100000000000000010000000000000000000000001
100100000000000000010000000000000000000000001
100100000000000000010000000000000000000000001
111111111111111111111111111111111111111111111